amino_acid	enzyme
ala__L_c	Ala_RS_tetra
arg__L_c	ArgS_mono
asn__L_c	Asn_RS_dim
asp__L_c	Asp_RS_dim
cys__L_c	generic_cys_ligase
gln__L_c	CPLX_dummy
glu__L_c	generic_glu_ligase
gly_c	CPLX-tRNA-GLY-LIGASE
his__L_c	His_RS_dim
ile__L_c	IleS_mono
leu__L_c	LeuS_mono
lys__L_c	generic_lys_ligase
met__L_c	Met_RS_dim
phe__L_c	CPLX-tRNA-PHE-LIGASE
pro__L_c	Pro_RS_dim
ser__L_c	CPLX_dummy
thr__L_c	Thr_RS_dim
trp__L_c	Trp_RS_dim
tyr__L_c	Tyr_RS_dim
val__L_c	ValS_mono
